R 900 800
NO ./texture/path_to_north_texture.xpm
SO ./texture/path_to_south_texture.xpm
WE ./texture/path_to_west_texture.xpm
EA ./texture/path_to_east_texture.xpm

S ./texture/path_to_sprite_texture.xpm

F 220,100,0
C 225,30,0

11111111111111111111
10011000000011000001
10111011100121100001
1000001 100010000011
101110111000000001
100110111111111111
100000000100011111
1110020000000000001
10000000S0000000001
1000000000000000001
1000000000000000001
1000000000000000001
1000000000000000001
1000000000000000001
1000000000000000001
1110101001000000001
111111110100011111
 1011 1001111
 1111 1111111
