R 1000 1000

NO ./texture/city.xpm
EA ./texture/sky.xpm
SO ./texture/sky.xpm
WE ./texture/sky.xpm

S ./texture/sky.xpm

F 220,100,0
C 225,30,0

1111111111
1000000001
1000000011
1010010101
1000000001
10000N1001
1000001001
1000000001
 11111111
