R 700 500
NO ./texture/path_to_north_texture.xpm
SO ./texture/path_to_south_texture.xpm
WE ./texture/path_to_west_texture.xpm
EA ./texture/path_to_east_texture.xpm

S ./texture/path_to_sprite_texture.xpm

F 220,100,0
C 225,30,0

        111111111111111111111111111
        100000000011000000011000001
        101100000111000000121100001
        100100000000000000010000011
        1011000001110000000000001
111111110011000001110111111111111
11110111111111010000000010001
11000000110101011100000010001
1000200000000000000000000001
10000000000000001101010010001
11000001110101011111011110N0111
11110111 1110101 101111010001
11111111 1111111 111111111111
