R 1000 1000

NO ./texture/sad_forest.xpm
EA ./texture/sad_forest.xpm
SO ./texture/sad_forest.xpm
WE ./texture/sad_forest.xpm

S ./texture/sky.xpm

F 220,100,0
C 225,30,0

1111111111
1000000201
1000000011
1012010101
1010000001
10100N1001
1010001201
1010000001
 11111111
