R 1000 1000
NO ./texture/path_to_north_texture.xpm
SO ./texture/path_to_south_texture.xpm
WE ./texture/path_to_west_texture.xpm
EA ./texture/path_to_east_texture.xpm

S ./texture/path_to_sprite_texture.xpm

F 220,100,0
C 225,30,0

1111111111
1000200001
1000000011
1012010101
1000000001
10000N1001
1000001001
1000000001
 11111111
