R 1000 1000 

NO ./texture/sky.xpm
EA ./texture/sky.xpm
SO ./texture/sky.xpm
WE ./texture/sky.xpm

S ./texture/chest.xpm

F 220,100,0
C 225,30,0

11111111111111111111111
1101000120111111111111111
110000N000000001111111111
1100002000000001111111111
1100200000020001111111111
1100002000000001111111111
111111111111111111111111
