R 1000 1000

NO ./texture/mountain.xpm
EA ./texture/sad_forest.xpm
SO ./texture/chihiro_train.xpm
WE ./texture/city.xpm

S ./texture/portal.xpm

F 220,255,0
C 225,30,0

11111111111111111111111
11111111111111111111111
11111111111111111111111
11111111111111111111111
11111111111111111111111
11111111111111111111111
11111111111111111111111
11111111111111111111111
11111111111111111111111
11111111111111111111111
11111111111111111111111
11111111111111111111111
11111111111111111111111
11111111111111111111111
11111111111111111111111
11111111111111111111111
11111111111111111111111
11111111111111111111111
11111111111111111111111
11111111111111111111111
11111111111111111111111
11111111111111111111111
11111111111111111111111
11111111111111111111111
11111111111111111111111
11111111111111111111111
11111111111111111111111
11111111111111111111111
11111111111111111111111
11111111111111111111111
11111111111111111111111
11111111111111111111111
11111111111111111111111
11111111111111111111111
11111111111111111111111
11111111111111111111111
11111111111111111111111
11111111111111111111111
11010000111111111111111
110000200000001111111111
110E000210000011111111111
110020000000001111111111
11000002000001111111111
11111111111111111111111
 
