R 1000 1000 

NO ./texture/sky.xpm
EA ./texture/sky.xpm
SO ./texture/sky.xpm
WE ./texture/sky.xpm

S ./texture/chest.xpm

F 220,100,0
C 225,30,0

1111111111111111111111111111
1022002200222211111111111111
1000000011000011111111111111
1010010101111111111111111111
1010S000000000000000001111111111111111111
1010001001111111111101111111
1010001001111111111111111111
1000000000000011111111111111
 111111110111111111111111111
1111111111111111111111111111
1111111111111111111111111111
1111111111111111111111111111
1111111111111111111111111111
1111111111111111111111111111
1111111111111111111111111111
1111111111111111111111111111
1111111111111111111111111111
1111111111111111111111111111
1111111111111111111111111111
1111111111111111111111111111
1111111111111111111111111111
1111111111111111111111111111

