R 1000 1000

NO ./texture/mountain.xpm
EA ./texture/sad_forest.xpm
SO ./texture/chihiro_train.xpm
WE ./texture/city.xpm

S ./texture/chest.xpm

F 220,25,0
C 225,30,0

11111111111111111111111
11111111111111111111111
11111111111111111111111
11111111111111111111111
11111111111111111111111
11111111111111111111111
11111111111111111111111
11111111111111111111111
11111111111111111111111
11111111111111111111111
11111111111111111111111
11111111111111111111111
11111111111111111111111
11111111111111111111111
11111111111111111111111
11111111111111111111111
11111111111111111111111
11111111111111111111111
11111111111111111111111
11111111111111111111111
11111111111111111111111
11111111111111111111111
11111111111111111111111
11111111111111111111111
11111111111111111111111
11111111111111111111111
11111111111111111111111
11111111111111111111111
11111111111111111111111
11111111111111111111111
11111111111111111111111
11111111111111111111111
11111111111111111111111
11111111111111111111111
11111111111111111111111
11111111111111111111111
11111111111111111111111
11111111111111111111111
110100000111111111111111
1100000000000001111111111
110E000002010000011111111111
110000000000001111111111
110000000000001111111111
11111111111111111111111
 
