R 500 500 

NO ./texture/sky.xpm
EA ./texture/sky.xpm
SO ./texture/sky.xpm
WE ./texture/sky.xpm

S ./texture/chest.xpm

F 220,100,0
C 225,30,0

1111111111111111111111111111
1022002200222211111111111111
1000000011000011111111111111
1010010101111111111111111111
1010S00001111111111111111111
1010001001111111111111111111
1010001001111111111111111111
1200000021000011111111111111
 11111111 111111111111111111
1111111111111111111111111111
1111111111111111111111111111
1111111111111111111111111111
1111111111111111111111111111
1111111111111111111111111111
1111111111111111111111111111
1111111111111111111111111111
1111111111111111111111111111
1111111111111111111111111111
1111111111111111111111111111
1111111111111111111111111111
1111111111111111111111111111
1111111111111111111111111111

