R 800 800 

NO ./texture/city.xpm
EA ./texture/city.xpm
SO ./texture/city.xpm
WE ./texture/city.xpm

S ./texture/chest.xpm

F 220,100,0
C 225,30,0

11111111111111111111111
1101002120111111111111111
110000N000000001111111111
1100002000000001111111111
1100200000020001111111111
1100002000000001111111111
111111111111111111111111
