R 1000 1000

SO ./texture/tile_1.xpm
EA ./texture/tile_2.xpm
NO ./texture/tile_3.xpm
WE ./texture/tile_4.xpm

S ./texture/ghost.xpm

F 82, 21, 21
C 48, 171, 231

111111111111111111
1012000002000000011
1011000000000001021111
10E001000100000111
100000000100111
10100111100010111111
100001  10000000211
111111  1111111111
 
