R 1920 1080
NO ./texture/path_to_north_texture.xpm
SO ./texture/path_to_south_texture.xpm
WE ./texture/path_to_west_texture.xpm
EA ./texture/path_to_east_texture.xpm

S ./texture/path_to_sprite_texture.xpm

F 220,100,0
C 225,30,0








        1111111111111111111111111
        1000000000110000000000001
        1011000001110000002000001
        1001000000000000000000001
        1011000001110000000000001
111111110011000001110111111111111
11110111111111011100000010001
11000000110101011100000010001
10002000000000001100000010001
10000000000000001101010010001
11000001110101011111011110N0111
11110111 1110101 101111010001
11111111 1111111 111111111111
